CCP = "countries/The Great Way Governmment.txt"
EHB = "countries/East Hebei.txt"
GUD = "countries/Guangdong.txt"
#JPS = "countries/Japanese Pacific States.txt"
SIC = "countries/Sichuan.txt"
RRC = "countries/Reorganized Republic of China.txt"
JNC = "countries/provgov.txt"
MEJ = "countries/Mengjiang.txt"
RFM = "countries/Reformed ROC.txt"
HPC = "countries/Chinese 29th Army.txt"
ECA = "countries/East Chahar Autonomous Region.txt"
XIK = "countries/Xikang.txt"
FIC = "countries/indochina.txt"
SST = "countries/Straits Settlements.txt"
PLM = "countries/Pailingmiao Council.txt"
MUA = "countries/MUA.txt"
NEA = "countries/Northeastern Army.txt"
HMI = "countries/Hami.txt"
SHD = "countries/Shandong.txt"
TNG = "countries/Tunganistan.txt"
NXM = "countries/Ningxia Ma Clique.txt"
GSM = "countries/Gansu Ma Clique.txt"
SHC = "countries/Shaanxi Clique.txt"
AAA = "countries/AAA.txt"
ZZZ = "countries/ZZZ.txt"
MAF = "countries/MAF.txt"
NSG = "countries/North Shanxi.txt"
SCG = "countries/South Chahar.txt"
BOR = "countries/North Borneo.txt"
SAR = "countries/Sarawak.txt"
CHP = "countries/Champasak.txt"
RFP = "countries/RFP.txt"
DPR = "countries/DPRK.txt"
KHR = "countries/Kashgar.txt"
XIA = "countries/Hunan.txt"
KRS = "countries/Karasahr.txt"
ATM = "countries/Altay Mountains.txt"
SUY = "countries/Suiyuan.txt"
EGM = "countries/Eastern Gansu Ma Clique.txt"
SRR = "countries/SRR.txt"